11111111111111111111111
10000000000000000000001
10000000000000000000001
10001110000000011111101
10000000001100000010101
10001110000000110000001
11111111111111111111111